01,05,05,05,05,05,05,05,05,05,05,05,05,05,05,05,05,05,01,01,05,05,05,05,05,05,05,05,05,05,05,05,05,05,05,05,05,05,05,05,05,05,05,05,05,05,05,05,05,05,05,05,01,01,01,01,01,01,01,01,01,01,01,01,01,01,01,01,01,01,01,01,01,01,01,01,01,01,01,01,01,01,01,01,05,05,05,05,05,05,05,05,05,05,05,05,05,05,05,00
00,05,05,05,05,05,05,05,05,05,05,05,05,05,05,05,05,05,01,01,01,05,05,05,05,05,05,05,05,05,05,05,05,05,05,05,05,05,05,05,05,05,05,05,05,05,05,05,05,05,05,05,01,01,01,01,01,01,01,01,01,01,01,01,01,01,01,01,01,01,01,07,07,07,07,07,07,01,01,01,01,01,01,05,05,05,05,05,05,05,05,05,05,05,05,05,05,05,05,00
00,05,05,05,05,05,05,05,05,05,05,05,05,01,01,01,05,05,01,01,01,01,05,05,05,05,05,05,05,05,05,05,05,05,05,05,05,05,05,05,05,05,05,05,05,05,05,05,01,01,05,05,01,01,01,01,01,01,01,01,01,01,01,01,01,01,01,01,01,01,07,05,05,05,05,05,05,07,01,01,01,01,05,05,05,05,05,05,05,05,05,05,05,05,05,05,05,05,05,00
00,05,05,05,05,05,05,05,05,05,05,05,05,05,05,05,05,05,01,01,01,01,01,05,05,05,05,05,05,05,05,05,05,05,05,05,05,05,05,05,05,05,05,05,05,05,05,05,05,05,05,05,01,01,01,01,01,01,01,01,01,01,01,01,01,01,01,01,01,01,05,05,05,05,05,05,05,05,01,01,01,05,05,05,05,05,05,05,05,05,05,05,05,05,05,05,05,05,05,00
00,05,05,05,05,05,05,05,05,05,05,05,05,05,05,05,05,05,01,01,01,01,01,01,05,05,05,05,05,05,05,05,05,05,05,05,05,05,05,05,05,05,05,01,01,01,01,05,05,05,05,05,01,01,01,01,01,01,01,01,01,01,01,01,01,01,01,01,01,01,05,05,05,05,05,05,05,05,01,01,05,05,05,05,05,05,05,05,05,05,05,05,05,05,05,05,05,05,05,00
00,05,05,05,05,05,05,05,05,01,01,01,05,05,05,05,05,05,01,01,01,01,01,01,01,05,05,05,05,05,05,05,05,05,05,05,05,05,05,05,05,05,05,05,05,05,05,05,05,05,05,05,01,01,01,01,01,01,01,01,01,01,01,01,01,01,01,01,01,01,05,05,05,00,05,05,05,05,01,05,05,05,05,05,05,05,05,05,05,05,05,05,05,05,05,05,05,05,05,00
00,05,05,05,05,05,01,01,05,05,05,05,05,05,05,05,05,05,01,01,01,01,01,01,01,01,05,05,05,05,05,05,05,05,05,05,05,05,05,05,01,01,05,05,05,05,05,05,05,05,05,05,01,01,01,01,01,01,01,01,01,01,01,01,01,01,01,01,01,01,05,05,05,01,00,05,05,05,01,05,05,05,05,05,05,05,05,05,05,05,05,05,05,05,05,05,05,05,05,00
00,05,05,05,05,05,05,05,05,05,05,05,05,05,05,05,05,05,01,01,01,01,01,01,01,01,01,05,05,05,05,05,05,05,05,05,05,05,05,05,05,05,05,05,05,05,05,05,05,05,05,05,01,01,01,01,01,01,01,01,01,01,01,01,01,01,01,01,01,01,05,05,05,01,01,05,05,05,01,05,05,05,05,05,05,05,05,05,05,05,05,05,05,05,05,05,05,05,05,00
00,08,05,05,05,05,05,05,05,05,05,05,05,05,05,05,05,05,01,01,01,01,01,01,01,01,01,01,00,00,00,00,00,00,00,05,05,05,05,05,05,05,05,05,05,05,05,00,00,05,05,05,01,01,01,01,01,01,01,01,01,01,01,01,01,01,01,01,01,01,05,05,05,01,01,05,05,05,01,05,05,05,05,05,05,05,05,05,05,05,05,05,05,05,05,05,05,05,05,00
00,01,01,01,01,01,01,01,01,01,01,01,01,01,01,01,03,03,01,01,01,01,01,01,01,01,01,01,01,01,01,01,01,01,01,03,03,03,01,01,01,01,01,01,01,01,01,01,01,03,03,03,01,01,01,01,01,01,01,01,01,01,01,01,01,01,01,01,01,01,03,03,03,01,01,03,03,03,01,01,01,01,01,01,01,01,01,01,01,01,01,01,01,01,01,01,01,01,01,00
00,05,05,05,05,05,05,05,05,05,05,05,05,05,05,05,02,02,05,05,05,05,05,05,05,05,05,05,05,05,05,05,05,05,05,02,02,02,05,05,05,05,05,05,05,05,05,05,05,02,02,02,05,05,05,05,05,05,05,05,05,05,05,05,05,05,05,05,05,05,02,02,02,05,05,02,02,02,05,05,05,05,05,05,05,05,05,05,05,05,05,05,05,05,05,05,05,05,05,00
00,01,01,01,01,01,01,01,01,01,01,01,01,01,01,01,01,01,05,05,05,05,05,05,05,05,01,01,01,01,01,01,04,04,04,01,01,01,04,04,04,04,04,04,04,04,04,04,05,01,01,01,01,01,01,01,01,01,01,01,01,01,01,01,01,01,01,01,01,01,01,01,01,04,05,01,01,01,05,04,04,04,04,04,04,04,04,04,04,04,04,04,04,04,04,04,04,04,04,00
00,01,01,01,01,01,01,01,01,01,01,01,01,01,01,01,01,01,05,05,05,05,05,05,05,01,01,01,01,01,01,01,01,01,01,01,01,01,01,01,01,01,01,01,01,01,01,01,05,01,01,01,01,01,01,01,01,01,01,01,01,01,01,01,01,01,01,01,01,01,01,01,01,01,05,01,01,01,05,01,01,01,01,01,01,01,01,01,01,01,01,01,01,01,01,01,01,01,01,00
00,01,01,01,01,01,01,01,01,01,01,01,01,01,01,01,01,01,05,05,05,05,05,05,01,01,01,01,01,01,01,01,01,01,01,01,01,01,01,01,01,01,01,01,01,01,01,01,05,01,01,01,01,01,01,01,01,05,05,01,01,01,01,01,01,01,01,01,01,01,01,01,01,01,05,01,01,01,05,05,05,05,05,05,05,05,05,05,05,05,05,05,05,05,05,05,05,05,05,00
00,01,01,01,01,01,01,01,01,01,01,01,01,01,01,01,01,01,05,05,05,05,01,01,01,01,01,01,01,01,01,01,01,01,01,01,01,01,01,01,01,01,01,01,01,01,01,01,05,01,01,01,01,01,01,01,01,01,01,01,01,01,01,05,01,01,01,01,01,01,01,01,01,01,05,01,01,01,01,01,01,01,01,01,01,01,01,01,01,01,01,01,01,01,01,01,01,01,01,00
00,01,01,01,01,01,01,01,01,01,01,01,01,01,01,01,01,01,05,05,01,01,01,01,01,01,01,01,01,01,01,01,01,01,01,01,01,01,01,01,01,01,01,01,01,01,01,01,05,06,06,06,01,01,01,01,01,01,01,01,01,01,01,01,05,05,05,05,05,05,01,01,01,01,05,01,01,01,01,01,01,01,01,01,01,01,01,01,01,01,01,01,01,01,01,01,01,01,01,00
00,01,01,01,01,01,01,01,01,01,01,01,01,01,01,01,01,01,05,01,01,01,01,01,01,01,01,01,01,01,01,01,01,01,01,01,01,01,01,01,01,01,01,01,01,01,01,01,05,05,05,05,01,01,01,01,01,01,01,01,01,01,01,01,01,01,01,01,01,01,01,01,01,01,05,01,01,01,01,01,01,01,01,01,01,01,01,01,01,01,01,01,01,01,01,01,01,01,01,00
00,01,01,01,01,01,01,01,01,01,01,01,01,01,01,01,01,01,01,01,01,01,01,01,01,01,01,01,01,01,01,01,01,01,01,01,01,01,01,01,01,01,01,01,01,01,01,01,05,05,05,05,01,01,01,01,01,01,01,01,01,01,01,01,01,01,01,01,01,01,01,01,01,01,05,01,01,01,01,01,01,01,01,01,01,01,01,01,01,01,01,01,01,01,01,01,01,01,01,00
00,01,01,01,01,01,01,01,01,01,01,01,01,01,01,01,01,01,01,01,01,01,01,01,01,01,01,01,01,01,01,01,01,01,01,01,01,01,01,01,01,01,01,01,01,01,01,01,05,05,05,05,01,01,01,01,01,01,01,01,01,01,01,01,05,05,05,05,05,05,01,01,01,01,05,01,01,01,01,01,01,01,01,01,01,01,01,01,01,01,01,01,01,01,01,01,01,01,01,00
00,01,01,01,01,01,01,01,01,01,01,01,01,01,01,01,01,01,01,01,01,01,01,01,01,01,01,01,01,01,01,01,01,01,01,01,01,01,01,01,01,01,01,01,01,01,01,01,05,05,05,05,01,01,01,01,01,01,01,01,01,01,01,05,01,01,01,01,01,01,01,01,01,01,05,01,01,01,01,01,01,01,01,01,01,01,01,01,01,01,01,01,01,01,01,01,01,01,01,00
