01,05,05,05,05,05,05,05,05,05,05,05,05,05,05,05,05,05,05,05,05,05,05,05,05
01,05,05,05,05,05,05,05,05,05,05,05,05,05,05,05,05,05,05,05,05,05,05,05,05
01,05,05,05,05,05,05,05,05,05,05,05,05,05,05,05,05,05,05,05,05,05,05,05,05
01,05,05,05,05,05,05,05,05,05,05,05,05,05,05,05,05,05,05,05,05,05,05,05,05
01,05,05,05,05,05,05,05,05,05,05,05,05,05,05,05,05,05,05,05,05,05,05,05,05
01,05,05,05,05,05,05,05,05,05,05,05,05,05,05,05,05,05,05,05,05,05,05,05,05
01,05,05,05,05,05,05,05,05,05,05,05,05,05,05,00,00,00,00,00,00,00,00,00,00
01,05,05,05,05,05,05,05,05,05,05,05,05,05,05,01,01,01,01,01,01,01,01,01,01
01,05,05,05,05,05,05,05,05,05,05,05,03,03,03,01,01,01,01,01,01,01,01,01,01
01,01,01,01,01,01,01,01,01,01,01,01,03,03,03,01,01,01,01,01,01,01,01,01,01
05,05,05,05,05,05,05,05,05,05,05,05,02,02,02,05,05,05,05,05,05,05,05,05,05
05,05,05,05,05,05,05,05,05,05,05,05,02,02,02,01,01,01,01,01,01,01,01,01,01
05,05,05,05,05,05,05,05,05,05,05,05,01,01,01,01,01,01,01,01,01,01,01,01,01
04,04,04,04,04,04,04,04,04,04,04,04,01,01,01,01,01,01,01,01,01,01,01,01,01
01,01,01,01,01,01,01,01,01,01,01,01,01,01,01,01,01,01,01,01,01,01,01,01,01
01,01,01,01,01,01,01,01,01,01,01,01,01,01,01,01,01,01,01,01,01,01,01,01,01
01,01,01,01,01,01,01,01,01,01,01,01,01,01,01,01,01,01,01,01,01,01,01,01,01
01,01,01,01,01,01,01,01,01,01,01,01,01,01,01,01,01,01,01,01,01,01,01,01,01
01,01,01,01,01,01,01,01,01,01,01,01,01,01,01,01,01,01,01,01,01,01,01,01,01
01,01,01,01,01,01,01,01,01,01,01,01,01,01,01,01,01,01,01,01,01,01,01,01,01

